be - être
I - je
you - tu
the - la
a - un
to - à
it - ce
not - ne pas
that - ce
and - et
of - de
do - fais
have - ont
what - Quel
we - nous
in - dans
get - obtenir
this - cette
my - ma
me - moi
go - aller
oh - oh
can - boîte
no - non
on - sur
for - pour
know - connaître
just - juste
your - ton
all - tout
so - alors
with - avec
he - il
but - mais
yeah - Oui
well - bien
think - pense
here - ici
want - vouloir
out - dehors
about - sur
good - bien
come - viens
up - en haut
say - dire
now - à présent
at - à
one - une
hey - hé
they - elles ou ils
see - voir
if - si
how - comment
like - Comme
she - elle
look - voir
make - Fabriquer
right - droit
guy - mec
take - prendre
let - laisser
really - vraiment
her - son
uh - euh
tell - raconter
him - lui
why - Pourquoi
there - là
who - qui
time - temps
thing - chose
from - de
will - sera
like - Comme
when - lorsque
as - comme
because - car
some - quelques
our - notre
yes - oui
there - là
back - retour
mean - moyenne
man - homme
little - peu
give - donner
his - le sien
us - nous
them - leur
need - besoin
then - alors
shall - devoir
or - ou
talk - parler
something - quelque chose
where - où
great - génial
way - façon
never - jamais
call - appel
too - aussi
by - par
sorry - Pardon
over - plus de
love - aimer
wait - Attendez
more - Suite
down - vers le bas
day - journée
two - deux
people - personnes
God - Dieu
very - très
work - travailler
thank - remercier
big - gros
try - essayer
dad - papa
maybe - peut être
feel - se sentir
friend - ami
even - même
sure - Bien sur
find - trouver
kid - enfant
these - ces
boy - garçon
put - mettre
happen - se produire
much - beaucoup
stop - arrêt
night - nuit
bad - mal
into - dans
those - ceux
right - droit
first - première
leave - Pars
year - an
hear - écouter
right - droit
ever - déjà
Mr - M
again - encore
use - utilisation
mom - maman
may - peut
hi - salut
life - la vie
nice - agréable
new - Nouveau
still - toujours
kind - gentil
only - seulement
baby - bébé
than - que
fine - bien
hello - bonjour
keep - donjon
girl - fille
help - aider
believe - croire
woman - femme
lot - parcelle
play - jouer
ask - interroger
start - début
home - domicile
nothing - rien
hmm - hmm
their - leur
meet - rencontrer
huh - hein
show - Afficher
around - autour de
guess - deviner
old - Agé de
hell - enfer
before - avant de
always - toujours
three - Trois
wow - wow
listen - Ecoutez
thanks - Merci
minute - minute
actually - réellement
eat - manger
place - place
live - Direct
away - une façon
after - après
bring - apporter
every - tous
everything - tout
money - argent
person - la personne
watch - Regardez
other - autre
remember - rappelles toi
house - loger
wrong - mauvais
kill - tuer
school - école
everyone - tout le monde
run - Cours
late - en retard
care - se soucier
car - auto
move - mouvement
ah - ah
idea - idée
another - une autre
turn - tour
real - réel
happy - heureux
whole - ensemble
week - la semaine
job - travail
fun - amusement
problem - problème
break - Pause
world - monde
which - qui
must - devoir
party - faire la fête
buy - acheter
through - à travers
together - ensemble
room - chambre
family - famille
stay - rester
lose - perdre
stuff - des trucs
son - fils
stupid - stupide
name - Nom
everybody - Tout le monde
last - dernière
long - long
tonight - ce soir
child - enfant
sit - asseoir
course - cours
pretty - jolie
hold - tenir
game - Jeu
forget - Oubliez
else - autre
own - posséder
five - cinq
second - deuxième
doctor - docteur
dollar - dollar
enough - suffisant
dog - chien
funny - drôle
wear - usure
die - mourir
sir - Monsieur
hard - dur
honey - Miel
sound - du son
sex - sexe
hate - détester
suppose - supposer
God - Dieu
head - tête
understand - comprendre
whoa - whoa
movie - film
worry - inquiétude
cool - cool
marry - marier
miss - Mademoiselle
pay - Payer
hour - heure
crazy - fou
change - monnaie
hot - chaud
most - plus
excuse - excuse
mother - mère
check - Chèque
pick - prendre
word - mot
same - même
yourself - toi-même
ready - prêt
seem - sembler
win - gagner
walk - marche
father - père
story - histoire
already - déjà
hope - espoir
part - partie
open - ouvert
lady - la demoiselle
read - lis
drink - boisson
sleep - dormir
number - Numéro
write - écrivez
morning - Matin
tomorrow - demain
next - Suivant
phone - téléphoner
four - quatre
last - dernière
once - une fois que
probably - Probablement
without - sans pour autant
many - de nombreux
such - tel
eye - œil
drive - conduire
wife - épouse
book - livre
hang - pendre
since - puisque
throw - jeter
name - Nom
dead - morte
stand - supporter
myself - moi même
aw - oh
dinner - dîner
hand - main
each - chaque
anyway - De toute façon
television - télévision
learn - apprendre
shut - fermer
town - ville
beautiful - belle
both - tous les deux
date - Date
spend - dépenser
office - Bureau
hit - succès
yet - encore
save - enregistrer
true - vrai
sweet - sucré
food - aliments
while - tandis que
send - envoyer
high - haute
anymore - plus
also - aussi
news - nouvelles
Christmas - Noël
ten - Dix
ass - cul
business - Entreprise
only - seulement
couple - couple
totally - totalement
door - porte
gay - homosexuel
exactly - exactement
parent - parent
few - peu
month - mois
easy - facile
deal - accord
ow - aïe
hurt - blesser
nobody - personne
perfect - parfait
lie - mentir
free - libre
young - Jeune
weird - bizarre
whatever - peu importe
brother - frère
work - travailler
kid - enfant
ago - depuis
end - fin
other - autre
ball - Balle
finally - finalement
line - ligne
its - son
ha - Ha
important - important
fall - tomber
heart - cœur
long - long
fat - gros
class - classer
shoot - tirer
picture - image
sell - vendre
side - côté
wish - souhaiter
love - aimer
mind - dérange
hair - Cheveu
cut - Couper
wedding - mariage
reason - raison
become - devenir
least - moins
look - voir
bite - morsure
fuck - Merde
under - en dessous de
bed - lit
paper - papier
different - différent
catch - attraper
mine - mien
six - six
set - Positionner
face - Visage
speak - parler
suck - sucer
sometimes - quelquefois
city - ville
special - spécial
stick - coller
question - question
dude - mec
realize - prendre conscience de
point - indiquer
enjoy - prendre plaisir
fact - fait
dance - Danse
soon - bientôt
bar - bar
wonder - merveille
joke - plaisanter
relationship - relation
chance - chance
black - le noir
almost - presque
fight - lutte
card - carte
song - chanson
little - peu
bye - au revoir
coffee - café
awesome - impressionnant
sick - malade
apartment - appartement
sorry - Pardon
back - retour
figure - chiffre
pull - tirer
box - boîte
dream - rêver
decide - décider
store - boutique
bet - pari
lunch - déjeuner
face - Visage
afraid - peur
buddy - copain
cute - mignonne
close - proche
bathroom - salle de bains
show - Afficher
mind - dérange
steal - voler
full - plein
company - compagnie
front - de face
ahead - en avant
moment - moment
case - Cas
date - Date
though - pourtant
body - corps
Mrs - Mme
pants - les pantalons
bitch - chienne
promise - promettre
glad - content
kiss - embrasser
either - Soit
fire - Feu
grow - grandir
build - construire
table - table
ticket - billet
matter - question
teach - apprendre
cat - chat
sister - sœur
girlfriend - petite amie
hat - chapeau
touch - toucher
terrible - terrible
beer - Bière
damn - Zut
mm-hmm - mm-hmm
club - club
amaze - étonner
smell - sentir
gift - cadeau
serious - sérieuse
plan - planifier
street - rue
team - équipe
order - ordre
cry - cri
zero - zéro
drop - goutte
act - loi
alone - seul
seat - siège
eh - hein
between - entre
eight - huit
twenty - vingt
foot - le pied
seven - Sept
finish - terminer
gentleman - gentleman
hand - main
point - indiquer
blow - souffler
small - petit
trouble - difficulté
sweetie - ma chérie
sing - chanter
pass - passer
beat - battre
piece - pièce
shoe - chaussure
welcome - accueillir
god - dieu
white - blanche
kick - donner un coup
bag - sac
fire - Feu
early - tôt
excite - exciter
wonderful - magnifique
seriously - sérieusement
country - pays
mouth - bouche
question - question
dear - chère
quite - assez
smart - intelligent
husband - mari
shh - chut
invite - inviter
rest - le repos
yours - le tiens
behind - derrière
key - clé
end - fin
dress - robe
red - rouge
laugh - rire
help - aider
machine - machine
yep - ouais
return - revenir
space - espace
mad - fou
truth - vérité
ice - la glace
follow - suivre
idiot - idiot
rule - régner
absolutely - Tout à fait
next - Suivant
against - contre
American - Américain
need - besoin
scare - effrayer
notice - remarquer
chicken - poulet
ride - balade
music - musique
join - rejoindre
next - Suivant
good-bye - au revoir
ruin - ruine
war - guerre
screw - vis
light - lumière
along - sur
poor - pauvre
sense - sens
able - pouvoir
matter - question
secret - secret
fly - mouche
top - Haut
sure - Bien sur
fair - équitable
relax - Détendez-vous
boyfriend - copain
plan - planifier
mistake - erreur
luck - chance
group - groupe
daughter - la fille
college - collège
president - Président
far - loin
sign - pancarte
close - proche
message - message
freak - Freak
fault - défaut
quick - rapide
single - Célibataire
shirt - chemise
choice - choix
attention - attention
power - Puissance
quit - quitter
answer - réponse
trust - confiance
fifty - cinquante
leg - jambe
wake - se réveiller
human - Humain
star - étoile
student - étudiant
air - air
chair - chaise
gun - pistolet
begin - commencer
death - décès
tree - arbre
boss - chef
while - tandis que
present - cadeau
instead - Au lieu
lucky - chanceux
safe - sûr
cold - froid
ahh - ah
explain - Explique
video - vidéo
brain - cerveau
completely - totalement
voice - voix
cake - gâteau
drink - boisson
trip - voyage
monkey - singe
hundred - cent
fix - réparer
entire - entier
expect - attendre
million - million
allow - Autoriser
forever - toujours
ugh - Pouah
hide - cacher
huge - énorme
interesting - intéressant
fight - lutte
roll - rouleau
clothes - vêtements
fast - vite
grab - saisir
teacher - prof
crap - et mince
animal - animal
burn - brûler
tough - dure
restaurant - restaurant
sort - trier
tooth - dent
marriage - mariage
proud - fier
uncle - oncle
push - pousser
butt - bout
offer - offrir
lord - seigneur
unless - sauf si
feeling - sentiment
suit - costume
uh-huh - euh-huh
floor - sol
cream - crème
favorite - favori
naked - nu
list - liste
ring - bague
clean - nettoyer
clear - dégager
Earth - Terre
share - partager
fill - remplir
cool - cool
pizza - pizza
ridiculous - ridicule
alive - vivant
pretend - faire semblant
hospital - hôpital
sad - triste
bunch - groupe
half - demi
police - police
fish - poisson
window - la fenêtre
busy - occupé
sign - pancarte
call - appel
pie - tarte
answer - réponse
raise - soulever
somewhere - quelque part
sandwich - sandwich
thirty - trente
sale - vendre
choose - choisir
definitely - absolument
swear - jurer
pretty - jolie
boat - bateau
tired - fatigué
ho - ho
upset - bouleversé
less - moins
nine - neuf
thousand - mille
smoke - fumée
embarrass - embarrasser
band - bande
bear - ours
none - rien
Santa - Père Noël
strong - fort
law - droit
toilet - toilette
jump - saut
count - compter
egg - Oeuf
Saturday - Samedi
blue - bleu
horrible - horrible
shit - merde
favor - favoriser
handle - manipuler
wall - mur
art - art
cover - couverture
arm - bras
perhaps - peut-être
simple - Facile
bus - bus
appreciate - apprécier
himself - lui-même
surprise - surprendre
candy - Des bonbons
finger - doigt
worth - la peine
state - Etat
possible - possible
rich - riche
short - court
king - Roi
knock - frappe
cookie - biscuit
penis - pénis
imagine - imaginer
third - troisième
blood - du sang
drug - médicament
future - avenir
prove - prouver
surprise - surprendre
alright - bien
captain - capitaine
evening - soirée
congratulations - toutes nos félicitations
system - système
record - enregistrement
age - âge
deserve - mériter
normal - Ordinaire
yesterday - hier
jerk - secousse
yay - Yay
bird - oiseau
nose - nez
bother - embêter
fan - ventilateur
letter - lettre
rather - plutôt
head - tête
interested - intéressé
owe - devoir
pregnant - Enceinte
destroy - détruire
bear - ours
evil - mauvais
milk - Le Lait
sport - sport
admit - admettre
apparently - Apparemment
conversation - conversation
obviously - évidemment
uh-oh - euh-oh
jacket - veste
during - durant
dumb - stupide
bit - bit
consider - envisager
mention - mention
step - marcher
deal - accord
hungry - faim
situation - situation
lead - conduire
twelve - Douze
fantastic - fantastique
hole - trou
plus - plus
note - Remarque
test - test
honest - honnête
character - personnage
holy - saint
manager - gestionnaire
lesson - leçon
soul - âme
nope - Nan
darkwine - foncévin
road - route
calm - calmes
personal - personnel
clown - clown
horse - cheval
gosh - ça alors
mayor - maire
sexy - sexy
dirty - sale
carry - porter
professor - professeur
bottle - bouteille
cheese - fromage
summer - été
remind - rappeler
afternoon - après midi
pee - pipi
angry - fâché
fella - gars
film - film
reach - atteindre
shower - douche
cup - Coupe
lawyer - avocat
camera - caméra
pain - la douleur
hurry - dépêche toi
desk - bureau
monster - monstre
certainly - assurément
cop - flic
credit - le crédit
prepare - préparer
anywhere - partout
breakfast - petit-déjeuner
bastard - bâtard
damn - Zut
church - église
hire - embaucher
decision - décision
Miss - Manquer
pig - cochon
loser - perdant
robot - robot
deep - Profond
park - parc
chocolate - Chocolat
service - service
Jew - Juif
tape - ruban
kitchen - cuisine
half - demi
rid - débarrasser
grandpa - grand-père
hero - héros
shot - tir
spot - endroit
folks - gens
yell - crier
awful - terrible
scene - scène
trick - tour
asshole - Connard
issue - publier
lovely - joli
visit - visite
honor - honneur
clean - nettoyer
second - deuxième
chick - poussin
costume - costume
Friday - Vendredi
hall - salle
Ms - Mme
fake - faux
forgive - pardonner
grade - noter
fifteen - quinze
ought - devrait
cheat - Tricher
Chinese - Chinois
crap - et mince
create - créer
hotel - Hôtel
magazine - magazine
settle - régler
accident - accident
boob - seins
excellent - excellent
neighbor - voisine
train - former
board - planche
pop - populaire
spirit - esprit
cow - vache
building - imeuble
ear - oreille
giant - géant
ugly - moche
toy - jouet
cancel - annuler
strange - étrange
aunt - tante
island - île
extra - En plus
fit - adapter
rock - rock
step - marcher
action - action
bill - facture
field - champ
kiss - embrasser
fresh - Frais
level - niveau
cost - Coût
size - Taille
cell - cellule
serve - servez
shake - secouer
neck - cou
bowl - bol
control - contrôler
loud - fort
bedroom - chambre
check - Chèque
heaven - paradis
right - droit
commercial - commercial
draw - dessiner
guest - invité
insane - fou
fail - échouer
cook - cuisinier
pleasure - plaisir
truck - un camion
science - la science
careful - prudent
nervous - nerveux
although - même si
gas - gaz
partner - partenaire
ew - euh
scream - pousser un cri
pool - bassin
appear - apparaître
clearly - clairement
silly - idiot
feed - nourrir
charge - charge
neither - ni
wash - lavage
stink - puer
magic - la magie
plane - avion
tiny - minuscule
prison - prison
cause - cause
photo - photo
public - Publique
button - bouton
flower - fleur
memory - Mémoire
own - posséder
fast - vite
base - base
involve - impliquer
madam - madame
blame - faire des reproches
tea - thé
whoo - whoo
bike - Bicyclette
freeze - gel
sexual - sexuel
code - code
celebrate - célébrer
couch - canapé
price - le prix
assume - présumer
delicious - délicieuse
forty - quarante
player - joueur
soup - le potage
waste - déchets
coat - manteau
doll - poupée
security - Sécurité
warm - chaleureuse
football - Football
model - maquette
whose - à qui
besides - outre
middle - milieu
shop - magasin
garbage - des ordures
client - client
ground - terrain
lame - boiteux
project - projet
dare - oser
shop - magasin
episode - épisode
glass - verre
green - vert
lock - bloquer
award - décerner
straight - droit
unbelievable - incroyable
court - rechercher
experience - vivre
final - final
large - grand
salad - salade
belong - appartenir
fuck - Merde
station - station
area - Région
vote - voter
crime - la criminalité
meat - Viande
romantic - romantique
treat - traiter
glasses - lunettes
lie - mentir
taste - goûter
weight - lester
mail - courrier
cab - taxi
two hundred - deux cent
boring - ennuyeuse
information - informations
total - total
channel - canaliser
page - page
suddenly - soudain
sake - Saké
Thanksgiving - Action de grâces
private - privé
French - Français
winner - gagnant
past - passé
pen - stylo
twice - deux fois
cousin - cousine
jealous - jaloux
mess - désordre
planet - planète
scary - angoissant
universe - univers
upstairs - en haut
genius - génie
dangerous - dangereux
nuts - des noisettes
ourselves - nous-mêmes
race - course
suggest - suggérer
turn - tour
sea - mer
officer - officier
meal - repas
popular - populaire
report - rapport
welcome - accueillir
flight - voyage en avion
change - monnaie
driver - chauffeur
wheel - la roue
dump - décharger
five hundred - cinq cents
member - membre
yo - toi
add - ajouter
confuse - embrouiller
form - formulaire
government - gouvernement
Sunday - Dimanche
order - ordre
continue - Continuez
event - un événement
quiet - calme
low - bas
color - Couleur
Jewish - juif
nah - non
breast - Sein
bank - banque
parking - parking
ride - balade
wild - sauvage
turkey - dinde
blah - blabla
thought - pensait
famous - célèbre
gold - or
pound - livre
skin - peau
one hundred - cent
rat - rat
switch - changer
tie - cravate
career - carrière
juice - jus
like - Comme
protect - protéger
shame - la honte
bottom - fond
respect - respect
underwear - sous-vêtement
Indian - Indien
closet - placard
meeting - Rencontre
sun - Soleil
bald - chauve
engage - engager
plant - plante
towel - serviette
mall - centre commercial
regular - habituel
bone - os
dig - creuser
fear - craindre
cancer - cancer
discuss - discuter
fancy - fantaisie
control - contrôler
advice - conseils
center - centre
apple - Pomme
everywhere - partout
holiday - vacance
cash - en espèces
common - commun
crush - écraser
mess - désordre
peace - paix
warn - prévenir
welcome - accueillir
adult - adulte
noise - bruit
rock - rock
super - super
bread - pain
fucking - putain de
porn - porno
three hundred - trois cents
type - taper
borrow - emprunter
department - département
plate - assiette
breathe - respirer
classic - classique
farm - cultiver
disgusting - répugnant
tall - haut
taste - goûter
replace - remplacer
somehow - en quelque sorte
theater - théâtre
discover - découvrir
incredible - incroyable
plenty - abondance
baseball - base-ball
comedy - la comédie
enter - Entrer
introduce - introduire
whenever - chaque fois que
butter - Beurre
possibly - peut-être
sweetheart - amoureux
jail - prison
season - saison
study - étude
miracle - miracle
complete - Achevée
golf - le golf
hook - accrocher
perfectly - à la perfection
stare - regard
flag - drapeau
jeez - merde
roommate - colocataire
ship - bateau
wood - bois
actor - acteur de cinéma
break - Pause
prize - prix
thanks - Merci
corner - coin
fourth - Quatrième
sneak - se faufiler
piss - pisse
pocket - poche
tip - pointe
alone - seul
lately - dernièrement
queen - reine
tear - larme
especially - surtout
lay - allonger
pressure - pression
rip - repose en paix
assistant - assistant
camp - camp
judge - juge
North - Nord
often - souvent
Halloween - Halloween
vacation - vacances
impossible - impossible
square - carré
left - la gauche
grandma - grand-mère
gross - brut
pal - copain
smile - le sourire
speech - parole
bust - bousiller
gee - bon sang
handsome - Beau
safety - sécurité
test - test
community - communauté
beach - plage
gym - Gym
toast - pain grillé
disease - maladie
paint - Peinture
themselves - eux-mêmes
Monday - Lundi
pack - paquet
punch - coup de poing
customer - client
healthy - en bonne santé
invent - inventer
princess - Princesse
merry - joyeux
someday - un jour
blind - aveugle
certain - certain
solve - résoudre
study - étude
sweater - chandail
terrific - formidable
wet - humide
attack - attaque
beg - mendier
cigarette - cigarette
sugar - du sucre
uhh - euh
weekend - fin de semaine
damn - Zut
sock - chaussette
emergency - urgence
mood - ambiance
peanut - cacahuète
stage - organiser
tight - serré
gum - gencive
moon - lune
nature - la nature
program - programme
straight - droit
angel - ange
damn - Zut
exist - exister
ghost - fantôme
sauce - sauce
stomach - estomac
twenty-five - vingt cinq
block - bloquer
herself - se
murder - meurtre
speed - la rapidité
Jesus - Jésus
mix - mélanger
track - Piste
opportunity - occasion
society - société
whoo-hoo - Whoo Hoo
upon - sur
difficult - difficile
killer - tueur
lip - lèvre
market - marché
goodness - bonté
pillow - oreiller
tie - cravate
arrive - arriver
mountain - Montagne
slip - caleçon
belt - ceinture
museum - musée
oil - pétrole
press - presse
respect - respect
airplane - avion
airport - aéroport
honestly - franchement
contest - concours
fabulous - fabuleux
spell - sort
whoever - quiconque
bell - cloche
friendship - relation amicale
national - nationale
alien - extraterrestre
dream - rêver
fool - idiot
past - passé
bless - bénir
cartoon - dessin animé
near - à proximité
swim - baignade
burger - Burger
fruit - fruit
roof - toit
theory - la théorie
according - selon
guilty - coupable
potato - Patate
dish - assiette
sound - du son
uncomfortable - inconfortable
wrap - envelopper
cheap - bon marché
employee - employé
interview - interview
perform - effectuer
spring - le printemps
text - texte
tour - tour
treat - traiter
awkward - gênant
expensive - chere
unfortunately - malheureusement
purse - sac
charge - charge
ha-ha - ha-ha
divorce - divorcer
ring - bague
bra - soutien-gorge
brown - brun
duck - canard
English - Anglais
celebrity - célébrité
double - double
period - période
rent - location
barely - à peine
bye-bye - Bye Bye
chip - ébrécher
ignore - ignorer
language - Langue
laundry - lessive
social - social
dress - robe
soft - mou, tendre
apology - excuses
concert - concert
disappoint - décevoir
knife - couteau
hilarious - hilarant
judge - juge
blanket - couverture
comic - bande dessinée
leader - chef
local - local
neighborhood - quartier
trap - piège
West - Ouest
bury - enterrer
whore - putain
cross - traverser
sheet - feuille
suffer - souffrir
tax - impôt
bath - bain
receive - recevoir
sometime - parfois
split - diviser
soda - un soda
talent - Talent
account - Compte
convince - convaincre
dessert - le dessert
purpose - objectif
report - rapport
weak - faible
cheer - bravo
move - mouvement
support - Support
research - rechercher
tongue - langue
Valentine - Valentin
pill - pilule
snake - serpent
battle - bataille
license - Licence
nut - noix
health - santé
natural - Naturel
gorgeous - magnifique
steak - bifteck
vagina - vagin
audience - spectateurs
knee - genou
term - terme
dance - Danse
score - score
sue - poursuivre en justice
artist - artiste
attack - attaque
bang - pan
bean - haricot
onto - sur
attractive - attrayant
breath - haleine
cover - couverture
empty - vide
lonely - solitaire
painting - La peinture
truly - vraiment
army - armée
avoid - éviter de
gang - gang
land - terrain
nerd - intello
others - les autres
slap - gifler
when - lorsque
appointment - rendez-vous
dick - queue
lesbian - lesbienne
outfit - tenue
adventure - aventure
devil - diable
liar - menteur
nurse - infirmière
pot - pot
responsible - responsable
salesman - vendeur
slow - lent
smile - le sourire
wallet - porte monnaie
commit - commettre
example - Exemple
fake - faux
obvious - évident
pirate - pirate
radio - radio
chase - chasse
due - exigible
familiar - familier
homework - devoirs
birth - naissance
Canadian - canadien
favorite - favori
prefer - préfère
rub - frotter
sky - ciel
basically - fondamentalement
coach - entraîneur
deliver - livrer
laboratory - laboratoire
address - adresse
lift - lever
concern - préoccuper
eleven - Onze
round - tour
wish - souhaiter
guard - gardien
contact - Contactez
over - plus de
package - forfait
travel - voyager
sixty - soixante
anniversary - anniversaire
cent - cent
force - Obliger
rest - le repos
spread - se propager
adorable - adorable
ocean - océan
percent - pour cent
shit - merde
wing - aile
above - au dessus
crash - crash
insurance - Assurance
nuclear - nucléaire
pathetic - pathétique
row - ligne
sight - vue
trash - déchets
available - disponible
brave - braver
climb - monter
earn - gagner
East - Est
impress - impressionner
league - ligue
online - en ligne
waste - déchets
within - dans
writer - écrivain
crowd - foule
flip - retourner
hug - étreinte
drag - glisser
funeral - funéraire
literally - au sens propre
lousy - pouilleux
opinion - opinion
pack - paquet
spit - cracher
van - van
behavior - comportement
complain - se plaindre
future - avenir
interest - intérêt
itself - lui-même
mirror - miroir
recently - récemment
stripper - décapant
subject - matière
bright - brillant
design - motif
general - général
kidney - enfantney
result - résultat
strike - la grève
corn - maïs
correct - corriger
grandmother - grand-mère
hug - étreinte
nightmare - cauchemar
ours - les notres
yellow - jaune
rise - monter
Christian - Christian
doughnut - Donut
original - original
position - position
quarter - trimestre
fool - idiot
annoy - ennuyer
can - boîte
match - match
play - jouer
traffic - Circulation
actual - réel
banana - banane
conference - conférence
lake - Lac
medical - médical
medicine - Médicament
pray - prier
shave - raser
tub - baignoire
bake - cuire
option - option
South - Sud
creepy - sinistre
douchebag - connard
eventually - finalement
interrupt - couper la parole
library - bibliothèque
rude - Impoli
advertisement - publicité
danger - danger
fourteen - Quatorze
master - Maître
math - math
propose - proposer
Thursday - Jeudi
apart - une part
darling - chérie
gather - rassembler
mostly - la plupart
support - Support
bubble - bulle
energy - énergie
heavy - lourd
laser - laser
manage - faire en sorte
meanwhile - pendant ce temps
network - réseau
weapon - arme
condition - condition
copy - copie
female - femelle
park - parc
quickly - rapidement
religion - la religion
snow - neiger
Tuesday - Mardi
version - version
bomb - bombe
clear - dégager
faith - Foi
innocent - innocent
remove - retirer
survive - survivre
bee - abeille
bride - la mariée
cause - cause
fifth - cinquième
several - plusieurs
basketball - basket
downtown - centre ville
freak - Freak
wipe - essuyer
arrest - arrêter
bored - ennuyé
bully - intimidateur
indeed - En effet
massage - massage
shape - forme
skip - sauter
strike - la grève
dry - sec
remain - rester
style - style
surgery - opération
toe - doigt de pied
yard - cour
brilliant - génial
circle - cercle
duty - devoir
enemy - ennemi
focus - se concentrer
lover - amoureux
midnight - minuit
simply - simplement
Spanish - Espagnol
boom - boom
describe - décris
legal - juridique
Mexican - mexicain
powerful - puissant
series - série
wire - fil
candle - bougie
diaper - couche
direction - direction
divorce - divorcer
eighteen - dix-huit
express - Express
plastic - Plastique
responsibility - responsabilité
starve - affamer
united - uni
worker - ouvrier
AIDS - sida
hope - espoir
immediately - immédiatement
nowhere - nulle part
separate - séparé
watch - Regardez
emotional - émotionnel
hardly - à peine
pilot - pilote
vampire - vampire
attitude - attitude
balloon - ballon
exact - exact
frankly - franchement
hip - hanche
pet - animaux
prank - canular
announcement - annonce
effect - effet
escape - échapper
nipple - téton
rough - rugueux
stick - coller
trade - Commerce
twin - double
waiter - serveur
architect - architecte
beauty - beauté
mate - camarade
official - officiel
practice - pratique
t-shirt - T-shirt
bug - punaise
crack - fissure
four hundred - quatre cents
half - demi
smoke - fumée
contract - Contrat
nail - clou
recognize - reconnaître
scientist - scientifique
set - Positionner
shoulder - épaule
successful - couronné de succès
turd - merde
view - voir
basement - sous-sol
degree - diplôme
fortune - fortune
hit - succès
invitation - invitation
nail - clou
oops - Oops
professional - professionnelle
search - chercher
swing - se balancer
train - former
weather - Météo
alarm - alarme
fun - amusement
kitty - minou
nap - sieste
practice - pratique
precious - précieux
product - produit
rabbit - lapin
role - rôle
snack - goûter
sucker - ventouse
tag - étiquette
chef - chef
chew - mâcher
evidence - preuve
fantasy - fantaisie
operation - opération
puppy - chiot
rain - pluie
spin - tournoyer
throat - gorge
e-mail - e-mail
present - cadeau
reality - réalité
saint - Saint
top - Haut
victim - victime
waitress - serveuse
booze - biberonner
condom - préservatif
director - directeur
hunt - chasse
menu - menu
mystery - mystère
quiet - calme
regret - regret
technically - techniquement
ton - tonne
attract - attirer
aware - au courant
chest - poitrine
dentist - dentiste
far - loin
focus - se concentrer
illegal - illégal
junior - junior
mouse - Souris
pencil - crayon
sentence - phrase
sixteen - seize
squeeze - presser
audition - audition
lobster - Homard
success - Succès
terrorist - terroriste
asleep - endormi
fashion - mode
glove - gant
item - Objet
recommend - recommander
tuna - Thon
warehouse - entrepôt
Italian - italien
lazy - paresseux
tank - Char
whale - baleine
zone - zone
honor - honneur
panic - panique
bachelor - bachelier
chain - chaîne
creature - créature
diamond - diamant
however - toutefois
image - image
parade - parade
rocket - fusée
solution - la solution
cable - câble
culture - Culture
forty-five - quarante-cinq
garage - garage
male - Masculin
revenge - vengeance
shrimp - crevette
taco - tacos
thin - mince
vote - voter
aside - de côté
bum - clochard
distract - distraire
DVD - DVD
hehe - hé hé
humiliate - humilier
locker - casier
native - originaire de
performance - performance
policy - politique
pony - poney
release - Libération
stone - pierre
woohoo - woohoo
advantage - avantage
basket - corbeille
breakup - rompre
device - dispositif
garden - jardin
patient - patient
pink - rose
represent - représenter
thirteen - treize
treasure - trésor
amount - montant
fart - Pet
newspaper - un journal
wind - vent
act - loi
ashamed - honteux
champion - champion
light - lumière
per - par
scout - scout
guitar - guitare
mental - mental
sensitive - sensible
twenty-four - vingt-quatre
heat - Chauffer
otherwise - Par ailleurs
seventeen - dix-sept
string - chaîne de caractères
wind - vent
downstairs - en bas
impressive - Impressionant
poop - caca
property - propriété
skill - compétence
walk - marche
dammit - merde
lead - conduire
pancake - crêpe
slow - lent
stranger - étranger
charity - charité
crap - et mince
freedom - liberté
pour - verser
stuff - des trucs
tradition - tradition
beef - bœuf
bite - morsure
bullet - balle
curious - curieux
disaster - un sinistre
factory - usine
forest - forêt
middle - milieu
odd - étrange
provide - apporter
repeat - répéter
section - section
subway - métro
choke - étouffer
cowboy - cow-boy
dirt - saleté
frog - grenouille
pumpkin - citrouille
swallow - avaler
bacon - lard
clever - intelligent
competition - concurrence
e-mail - e-mail
heh - il h
lick - lécher
mission - mission
pair - paire
soap - du savon
tail - queue
tattoo - tatouage
activity - activité
bridge - pont
detail - détail
diet - diète
insult - insulte
theme - thème
university - université
champagne - Champagne
charming - charmant
compare - comparer
gut - intestin
map - carte
napkin - serviette
punch - coup de poing
apply - appliquer
challenge - défi
collect - recueillir
cupcake - petit gâteau
fridge - frigo
imagination - imagination
joke - plaisanter
pad - tampon
script - scénario
whip - fouet
left - la gauche
affair - aventure
benefit - bénéficier à
beyond - au-delà
book - livre
citizen - citoyen
fart - Pet
grant - accorder
junk - déchet
magical - magique
prom - bal de promo
schedule - programme
studio - studio
value - évaluer
wise - sage
Bible - Bible
clue - indice
suicide - suicide
Wednesday - Mercredi
friendly - amical
claim - réclamer
complicate - compliquer
doubt - doute
generation - génération
grave - la tombe
require - exiger
stair - escalier
album - album
depend - dépendre
maid - Femme de ménage
moron - imbécile
necessary - nécessaire
oven - four
paint - Peinture
refer - se référer à
scratch - se gratter
spill - répandre
stain - tache
adopt - adopter
brush - brosser
delivery - livraison
disappear - disparaître
elementary - élémentaire
humor - humour
tear - larme
trap - piège
amazing - étonnante
Asian - asiatique
boot - botte
connection - lien
eve - veille
happiness - Bonheur
lifetime - durée de vie
officially - officiellement
quality - qualité
agreement - accord
argument - dispute
carpet - tapis
crisis - crise
design - motif
drawer - tiroir
further - plus loin
incredibly - incroyablement
loose - ample
pair - paire
refuse - refuser
risk - risque
selfish - égoïste
village - village
anger - colère
assure - assurer
bet - pari
bingo - bingo
bunny - lapin
crawl - crawl
demand - demande
desperate - désespéré
elevator - ascenseur
goat - chèvre
honeymoon - voyage de noces
insist - insister
million - million
murder - meurtre
penny - penny
usual - habituel
beloved - bien-aimé
copy - copie
festival - festival
tennis - tennis
threaten - menacer
beginning - début
cigar - cigare
dancer - Danseur
heck - Zut
low - bas
material - Matériel
Yankee - yankee
chapter - chapitre
chat - discuter
homeless - sans-abri
lap - tour
major - Majeur
mark - marque
river - fleuve
shark - requin
strength - force
accidentally - accidentellement
ancient - ancien
collection - le recueil
exercise - exercer
include - comprendre
muffin - muffin
offense - infraction
screen - filtrer
tomato - tomate
aha - aha
cafeteria - cafétéria
crack - fissure
crappy - merdique
Japanese - Japonais
statue - statue
supply - la fourniture
versus - contre
tool - outil
asleep - endormi
bend - pliez
commitment - engagement
disturb - déranger
fish - poisson
joy - joie
presentation - présentation
shove - pousser
tube - tube
being - étant
damn - Zut
experiment - expérience
fellow - compagnon
German - Allemand
jar - pot
mint - menthe
physical - physique
punish - punir
remote - télécommande
slut - salope
twist - tourner
cap - casquette
criminal - criminel
eight hundred - huit cent
inspire - inspirer
main - principale
panda - Panda
sink - évier
smooth - lisse
snap - instantané
thumb - pouce
witness - témoin
abandon - abandonner
affect - affecter
beard - barbe
bucket - seau
county - comté
gain - Gain
poem - poème
reporter - journaliste
review - examen
training - entraînement
among - parmi
battery - la batterie
deny - Nier
electric - électrique
flavor - saveur
forbid - interdire
fudge - truquer
hooray - hourra
obsess - obséder
positive - positif
rob - Rob
signal - signal
solid - solide
website - site Internet
aye - toujours
century - siècle
click - Cliquez sur
cracker - biscuit salé
dry-cleaning - Nettoyage à sec
dump - décharger
effort - effort
gate - portail
hooker - talonneur
impression - impression
inappropriate - inapproprié
inspector - inspecteur
statement - déclaration
thrill - frisson
wiener - saucisse
bond - obligation
challenge - défi
filthy - sale
grandfather - grand-père
host - héberger
producer - producteur
witch - sorcière
appropriate - approprié
coincidence - hasard
furniture - meubles
laugh - rire
lemon - citron
load - charger
mock - faux
normally - normalement
physics - la physique
sack - sac
stock - Stock
storm - tempête
wheelchair - fauteuil roulant
announce - annoncer
bagel - beignet
cocktail - cocktail
committee - Comité
crew - équipage
defense - la défense
extremely - extrêmement
file - dossier
haircut - la Coupe de cheveux
loss - perte
mark - marque
proof - preuve
salt - sel
score - score
spare - de rechange
tape - ruban
ex - ex
fairy - Fée
fort - fort
grape - grain de raisin
including - y compris
makeup - se maquiller
nation - nation
six hundred - six cent
block - bloquer
childhood - enfance
cut - Couper
develop - développer
race - course
reference - référence
shorts - shorts
talk - parler
therapist - thérapeute
tip - pointe
tone - Ton
warm - chaleureuse
accent - accent
avenue - rue
below - dessous
cloud - nuage
concern - préoccuper
distance - distance
doubt - doute
exhaust - échappement
goal - objectif
roll - rouleau
suggestion - suggestion
grocery - épicerie
belief - croyance
bump - cogner
inch - pouce
jury - jury
neat - soigné
odds - chances
reservation - réservation
rush - se ruer
spider - araignée
squirrel - écureuil
topic - sujet
toss - lancer
uniform - uniforme
violence - la violence
wide - large
zoo - zoo
boo - huer
bullshit - connerie
cruel - cruel
dial - cadran
jeans - jeans
pile - pile
poison - poison
pure - pur
romance - romance
slave - trimer
slowly - tout doucement
awake - éveillé
belly - ventre
booth - stand
gentle - doux
opera - opéra
pipe - tuyau
poster - affiche
Russian - russe
sweep - balayer
sword - épée
ultimate - ultime
debate - débat
explode - exploser
float - flotteur
justice - Justice
kick - donner un coup
poker - poker
pride - Orgueil
psych - psy
rain - pluie
rare - rare
rumor - rumeur
title - Titre
vision - vision
wrestle - lutter
column - colonne
connect - relier
hockey - le hockey
